25 20








  xxxxxxxxxxxxxxxxxxxx
  xf.f.f.f.f.f.f.f.f.x
  x.......s.........fx
  xf...........vvv...x
  x...s....s...vvv..fx
  xf.@........s......x
  x.................fx
  xf............s....x
  x.vvv.........s...fx
  xfvvv..............x
  x.f.f.f.f.f.f.f.f.fx
  xxxxxxxxxxxxxxxxxxxx
